11111111100111100111111111
10000000100100100100000001
10000000100100100100000001
10011111111100111111111001
10010010000100100001001001
11110010000100100001001111
00010010000100100001001000
00010011111100111111001000
11110000100000000100001111
10010000100000000100001001
10011111111111111111111001
10000100100000000100100001
10000100100000000100100001
11111100100000000100111111
10010000100000000100001001
10010000100000000100001001
10011111111111111111111001
10000100000100100000100001
10000100000100100000100001
11111100111100111100111111
00100100100000000100100100
00100100100000000100100100
11100111111111111111100111
10000100000100100000100001
10000100000100100000100001
11111100111100111100111111
10000100100000000000100001
10000100100000000000100001
11111100111111111100111111