11111100111111111100111111
10000100100000000100100001
11111111111111111111111111
00100100000100100000100100
00100100000100100000100100
00100100000100100000100100
11100111111100111111100111
00100000100000000100000100
00100000100000000100000100
00111111111111111111111100
00111111111111111111111100
00100000100000000100000100
00100000100000000100000100
00100111100000000111100100
00100111100000000111100100
00100100100000000100100100
11111100111111111100111111
00100000000100100000000100
00100000000100100000000100
00111111111100111111111100
00100000100000000100000100
00100000100000000100000100
11111111111111111111111111
10000100000100100000100001
10000100000100100000100001
10000100111100111100100001
10000100100000000100100001
10000100100000000100100001
11111111111111111111111111