11111111111111111111111111
10010000100000000100001001
10010000100000000100001001
10010000100000000100001001
10011111100100100111111001
10000100100100100100100001
10000100100100100100100001
11111100111100111100111111
00100000000100100000000100
00100000000100100000000100
00111100111111111100111100
00100100100000000100100111
11100111100000000111100111
00000111100000000111100000
00000111100000000111100000
11100111100000000111100111
00100100111111111100100100
00111100000100100000111100
00100100000100100000100100
00100111111100111111100100
00100000100000000100000100
00100000100000000100000100
11111111100111100111111111
10000100100000000100100001
10000100100000000100100001
10011100111111111100111001
10010000000100100000001001
10010000000100100000001001
11111111111111111111111111
