11111100111111111100111111
00000100100000000100100000
00000100100000000100100000
11111111111100111111111111
10000000100100100100000001
10000000100100100100000001
10011111100111100111111001
10010000100000000100001001
10010000100000000100001001
11111100100000000100111111
00000100111111111100100000
00000100100000000100100000
11111100100000000100111111
10000100100000000100100001
10000111100000000111100001
11100100100000000100100111
00100100111111111100100100
00100100001000010000100100
00100100001000010000100100
00111111111000011111111100
00100000001000010000000100
00100000001000010000000100
11111100111111111100111111
00100100100000000100100100
00100100100000000100100100
11100111111100111111100111
10000100000100100000100001
10000100000100100000100001
11111111111111111111111111